type octile
height 6
width 16
map
................
....@@@@@@@@....
................
....@@@@@@@@....
................
................